NO      ./resources/textures/vwall.xpm



     SO ./resources/textures/gate.xpm


	EA            ./resources/textures/port.xpm
     WE        ./resources/textures/piping.xpm


F       0,01,0


C 0,02,50


111111111111111111111111111111111111111
100000E0000000000010000000000000000001111111111
1000000000000000000000000000000000000000000011111111111
1111001111101110000000000000000011111111111111
1111111100000011111111111101111111
      111111111          101
                         101
                         101
                         101
                         101
                         101
                         101
                         101
                         101
                         111
