NO ./resources/textures/vwall.xpm
SO ./resources/textures/gate.xpm
EA ./resources/textures/port.xpm
WE ./resources/textures/piping.xpm

F 0,01,0
C 0,02,50

111111111111111
100000000000001
1000001111111111111111
100E001000000000000001
1000000000000000000001
1000001000000000000001
1111111111111111111111
