NO ./resources/textures/gate.xpm
SO ./resources/textures/vwall.xpm
EA ./resources/textures/port.xpm
WE ./resources/textures/piping.xpm

F 0,0,0

C 255,02,255

11111111111111111111111111
10000000000000000010000001
10000000000001000000000001
10000000000000000000000001
10000000000000001000000001
1W000000000000000000000001
10000001000011000010000001
10000000000001000001110001
10000000000000000000000001
10000000001111111101111111
10000000000000000000000001
10000001000011000010000001
10000000111011000001110001
10000000000000000000000001
10000000000100000000000001
10000000000001000001110001
10000000000000000000000001
10000000001111111101111111
10000000000000000000000001
10000001000011000010000001
10111000111011000001110001
10000000000000000000000001
11111111111111111111111111
